11 14
##############
#            #
#  F       % #
#######D###  #
#            #
#           $#
#        #####
#         ***#
#   ^        #
#            #
#####  #######