10 13
##############
#            #
#       %    #
#       ######
#            #
#            #
#        #####
#            #
#            #
#            #
##############