11 14 -1
######## #####
#%           #
   F$$        
#######D###  #
#*           #
#  ^        $#
#       F#####
#   ^     ** #
# ^          #
#*           #
#####DD#######