10 30 120
##############################
#         $                % #
#   ^        **    F         #
####  #####        #####  ####
# $#  **    ######        #**#
#  #        #F*  #        #^ #
# ^#######  #    D        D  #
#           ###### ########  #
#           **      **       #
##############################
