11 14
##############
#            #
#  F       % #
#######D###  #
#^           #
#           $#
#       F#####
#   ^     ***#
#            #
#            #
#####DD#######