11 14 200
##############
#% $$$$$$$$$$#
#  F$$$$$$$$$#
#######D###  #
#            #
#  ^        $#
#       F#####
#   ^     ***#
# ^          #
#            #
#####DD#######