20 21 60
####################
#F            #  **#
#  ^   *      #  **#
#             D    #
#$        *   ######
######             #
#**  #             #
#**  #        ^  * #
#    #            $#
##D###    ##########
#            $    F#
#*                 #
#                  #
#                * #
#                  #
#   %    ^         #
#              *   #
#                  #
#$   *             #
####################