10 13
##############
#            #
#  F    %    #
#######D######
#            #
#           $#
#        #####
#         ***#
#   ^        #
#            #
##############