11 16 -1
################
#%            *#
#  *          *#
#######D##     #
#*       #     #
#        #F   $#
#        #######
#              #
# ^            #
#*           **#
################