13 21 37
######################
#%                   #
#  F$$               #
#######D##############
#*                   #
#  ^                $#
#               F#####
#   ^             ** #
# ^                  #
#*                   #
###########D##########
#  **                #
#                    #
######################