7 12
###########
#         #
#    %    #
#         #
#         #
#         #
###########